"filename", "language", "Python", "comment", "blank", "total"
"c:\Users\lookc\Documents\GitHub\The-Jungle\code\classes\camera.py", "Python", 29, 0, 8, 37
"c:\Users\lookc\Documents\GitHub\The-Jungle\code\classes\level.py", "Python", 232, 10, 56, 298
"c:\Users\lookc\Documents\GitHub\The-Jungle\code\classes\opossum.py", "Python", 23, 0, 7, 30
"c:\Users\lookc\Documents\GitHub\The-Jungle\code\classes\platform.py", "Python", 11, 0, 2, 13
"c:\Users\lookc\Documents\GitHub\The-Jungle\code\classes\player.py", "Python", 192, 5, 37, 234
"c:\Users\lookc\Documents\GitHub\The-Jungle\code\classes\start.py", "Python", 32, 3, 3, 38
"c:\Users\lookc\Documents\GitHub\The-Jungle\code\classes\tile.py", "Python", 57, 0, 13, 70
"c:\Users\lookc\Documents\GitHub\The-Jungle\code\classes\ui.py", "Python", 51, 4, 14, 69
"c:\Users\lookc\Documents\GitHub\The-Jungle\code\functions\background.py", "Python", 29, 0, 7, 36
"c:\Users\lookc\Documents\GitHub\The-Jungle\code\functions\button.py", "Python", 18, 0, 7, 25
"c:\Users\lookc\Documents\GitHub\The-Jungle\code\functions\support.py", "Python", 49, 0, 12, 61
"c:\Users\lookc\Documents\GitHub\The-Jungle\code\game.py", "Python", 81, 4, 16, 101
"c:\Users\lookc\Documents\GitHub\The-Jungle\code\game_data.py", "Python", 93, 0, 6, 99
"c:\Users\lookc\Documents\GitHub\The-Jungle\code\overworld.py", "Python", 115, 0, 25, 140
"c:\Users\lookc\Documents\GitHub\The-Jungle\code\settings.py", "Python", 35, 3, 8, 46
"Total", "-", 1047, 29, 221, 1297